1111111111111
10010000Z00C1
1003011111001
1P0011E00X001
1111111111111
