1111111
1P111C1
1111111
11111E1
